
													SO ./textures/south.xpm
WE 	./textures/west.xpm

C        229, 107,          											111
EA ./textures/east.xpm
						 F 109, 89, 35

NO ./textures/north.xpm


        1111111111111111111111111
        0000000000110000000000001
        1011000001110000000000001
        1001000001000000000000001
111111111011000001110000000000001
100000000011000001110111111111111
1111011111110000N1010000001001
101110111111111111101010010001
110000001101010111000000101111
100000000   000011000000101
1000000000000000110101001011111
1100000111010101111101111000111
1111011011101011 101111010001
11111111 1111111 111111111111