1111111
1000101
1010001
11N1001
1111111