NO                       ./textures/north.xpm
SO ./textures/south.xpm
WE ./textures/west.xpm
EA ./textures/east.xpm

F 109, 89, 122
C 229, 107, 111

1111111111
1        1
1        1
1        1
1        1
1        1
111      1
  1      1
111      1
1        1
1        1111111111
1                N1
1111111111111111111111