
NO ./textures/north.xpm
SO ./textures/south.xpm
WE ./textures/east.xpm
EA ./textures/west.xpm

F 77,92,53
C 163,208,230

1111111111111111111111111
1000000000110000000000001
101100000111000000N000001
1001000000000000000000001
11111111111111111111111111
11111111 1111111 111111111111
