NO textures/north.xpm
SO textures/south.xpm
WE textures/east.xpm
EA textures/west.xpm

F 220,100,0
C 225,30,0

               1111
111111111111111111111111
0111001100000110011001111
11111111111W111111111111111
   111111111111111111111101
                  1111111111
                  1111111011
                  1111111111
