
NO textures/north.xpm
SO textures/south.xpm
WE textures/east.xpm
EA textures/west.xpm
F 0,255, 0
C 0, 0, 255
1111111
1000101
1000001
11N1001
1111111